1111111111111111111111
100100C000001001000001
1000011111001000101001
10P0110000C010001010E1
1111111111111111111111