1111111111111111111111
100100C000001000000001
1101011111001000100101
11000P0E01100010010101
1111111111111111111111