1111111111111111111111
1P0100C000001000000001
1000011111001000101001
1000110000C000001010E1
1111111111111111111111