1111111111111111111111111111111111111
100100C000001001100001010010101010101
1000011111001000101001010101010000001
10P0110000CE1000101010100101000110001
1111111111111111111111111111111111111