1111111111111111111111
1P01000E00001000000001
1101011111001000100101
10000C0001100010010101
1111111111111111111111