1111111111111111111111111111111111111
100100C000001001000001010010101010101
1000011111001000101001010101010000001
10P0110000C010001010E0100101000110001
1111111111111111111111111111111111111