1111111111111111111111111111111111
1P1000000000000C00000C000000000001
1010010100100000101001000000010101
1010010010101111111101000000010101
100000000C00C1E0000001000000000001
1111111111111111111111111111111111