1111111111111111111111111111111111
1E1000000000000C00000C0000000000E1
11100101001000001010010000000101C1
1010010010101111111101000000010101
100000000C0PC1C000000100000000C001
1111111111111111111111111111111111