1111111111111111111111
1P0100C0000010000001E1
1000011111001000100001
1000110000C00100101001
1111111111111111111111