11111111111111111111
10010000000C00000001
10000111110011001101
1P0011E0000000001C01
11111111111111111111