1111111111111111111111111111111
1E0000000000000C0000C0000000001
1111100011100011100001110000001
1000100000100000100000010000111
10001000111C0011100C011100000C1
1000100000100000100000010001111
10011100111000111C00000100000P1
1000000000000000000000000000001
1111111111111111111111111111111